################
#      @       #
#              #
#              #
#              #
#              #
#              #
#              #
#              #
#              #
#              #
#              #
#              #
#              #
#              #
################
