################
#L     @       #
#      X      F#
#  ooooo########
#              #
#            ss#
#  P        #ss#
#      P    #ss#
#           #ss#
#          L#ss#
#      P    #ss#
#           #ss#
#  P        #dd#
#        ####dd#
#V P    P#ddddV#
################
